ALL - Albanian lek
XCD - East Caribbean dollar
EUR - European Euro
BBD - Barbadian dollar
BTN - Bhutanese ngultrum
BND - Brunei dollar
XAF - Central African
CUP - Cuban peso
United States dollar - USD
FKP - Falkland Islands pound
GIP - Gibraltar pound
HUF - Hungarian forint
IRR - Iranian rial
JMD - Jamaican dollar
AUD - Australian dollar
LAK - Lao kip
LYD - Libyan dinar
MKD - Macedonian denar
XOF - West African CFA franc
NZD - New Zealand dollar
OMR - Omani rial
PGK - Papua New Guinean kina
RWF - Rwandan franc
WST - Samoan tala
RSD - Serbian dinar
SEK - Swedish krona
TZS - Tanzanian shilling
AMD - Armenian dram
BSD - Bahamian dollar
BAM - Bosnia and Herzegovina
CVE - Cape Verdean escudo
CNY - Chinese renminbi
CRC - Costa Rican colon
CZK - Czech koruna
ERN - Eritrean nakfa
GEL - Georgian lari
HTG - Haitian gourde
INR - Indian rupee
JOD - Jordanian dinar
KRW - South Korean won
LBP - Lebanese lira
MWK - Malawian kwacha
MRO - Mauritanian ouguiya
MZN - Mozambican metical
ANG - Netherlands Antillean gulden
PEN - Peruvian nuevo sol
QAR - Qatari riyal
STD - Sao Tome and Principe dobra
SLL - Sierra Leonean leone
SOS - Somali shilling
SDG - Sudanese pound
SYP - Syrian pound
AOA - Angolan kwanza
AWG - Aruban florin
BHD - Bahraini dinar
BZD - Belize dollar
BWP - Botswana pula
BIF - Burundi franc
KYD - Cayman Islands dollar
COP - Colombian peso
DKK - Danish krone
GTQ - Guatemalan quetzal
HNL - Honduran lempira
ILS - Israeli new sheqel
KZT - Kazakhstani tenge
KWD - Kuwaiti dinar
LSL - Lesotho loti
MYR - Malaysian ringgit
MUR - Mauritian rupee
MNT - Mongolian tugrik
MMK - Myanma kyat
NGN - Nigerian naira
PAB - Panamanian balboa
PHP - Philippine peso
RON - Romanian leu
SAR - Saudi riyal
SGD - Singapore dollar
ZAR - South African rand
SRD - Surinamese dollar
TWD - New Taiwan dollar
TOP - Paanga
VEF - Venezuelan bolivar
DZD - Algerian dinar
ARS - Argentine peso
AZN - Azerbaijani manat
BYR - Belarusian ruble
BOB - Bolivian boliviano
BGN - Bulgarian lev
CAD - Canadian dollar
Chilean peso - CLP
CDF - Congolese franc
DOP - Dominican peso
FJD - Fijian dollar
GMD - Gambian dalasi
GYD - Guyanese dollar
ISK - Icelandic kr√≥na
IQD - Iraqi dinar
JPY - Japanese yen
KPW - North Korean won
LVL - Latvian lats
CHF - Swiss franc
MGA - Malagasy ariary
MDL - Moldovan leu
MAD - Moroccan dirham
NPR - Nepalese rupee
NIO - Nicaraguan cordoba
PKR - Pakistani rupee
PYG - Paraguayan guarani
SHP - Saint Helena pound
SCR - Seychellois rupee
SBD - Solomon Islands dollar
LKR - Sri Lankan rupee
THB - Thai baht
TRY - Turkish new lira
AED - UAE dirham
VUV - Vanuatu vatu
YER - Yemeni rial
AFN - Afghan afghani
BDT - Bangladeshi taka
BRL - Brazilian real
KHR - Cambodian riel
KMF - Comorian franc
HRK - Croatian kuna
DJF - Djiboutian franc
EGP - Egyptian pound
ETB - Ethiopian birr
XPF - CFP franc
GHS - Ghanaian cedi
GNF - Guinean franc
HKD - Hong Kong dollar
XDR - Special Drawing Rights
KES - Kenyan shilling
KGS - Kyrgyzstani som
LRD - Liberian dollar
MOP - Macanese pataca
MVR - Maldivian rufiyaa
MXN - Mexican peso
NAD - Namibian dollar
NOK - Norwegian krone
PLN - Polish zloty
RUB - Russian ruble
SZL - Swazi lilangeni
TJS - Tajikistani somoni
TTD - Trin ad and Tobago dollar
UGX - Ugandan shilling
UYU - Uruguayan peso
VND - Vietnamese dong
TND - Tunisian dinar
UAH - Ukrainian hryvnia
UZS - Uzbekistani som
TMT - Turkmenistan manat
GBP - British pound
ZMW - Zambian kwacha
BTC - Bitcoin
